######----
#----#----
#----#----
#----#----
#----#----
######----
------#---
-------#--
--------#-
---------#
