##--------
--##------
--#-##----
--#---##--
--#-----#-
--#------#
---#------
---#------
---#------
----#-----
