----------
----------
--#-------
--#--##---
--#----##-
--#------#
---#------
---#------
---#------
----#-----
